12,2/12,8/2,8
##########:##########
#.$.$.$.$#:#.$$..#.$#
#$..@....#:#.#....$$#
#.......$#:#....#.$$#
#$.$.$.$x#:#.......xL
##########:####U#####
||||||||||:||||||||||
##########:##########
#R.L.#..$#:#.$.#.$..#
#$..$$..##:#........#
#UD..$$..L:#......Rx#
#Lx....$.#:#$.#..$.##
##########:##########
||||||||||:||||||||||