12, 1-12, 8-1, 8
##########:##########
#.$$#$$$$#:#.$$#$$$$#
#...@...$L:#.......$L
#.......$#:#.......$#
R$$#$$..x#:R$$#$$..x#
####U#####:####U#####
||||||||||:||||||||||
##########:##########
#.$##$$$$#:#.$##$$$$#
#..R..####:#..R..####
#.......x#:#.......x#
#$...#####:#$...#####
#U########:#U########
||||||||||:||||||||||