##########
#.$$#$$$$#
#...@...$L
#.......$#
R$$#$$..x#
##########
||||||||||
##########
#.$##$$$$#
#..R..####
#.......x#
#$...#####
#U########
||||||||||