12,1/12,8/2,8
##########:##########
#.$$#$$$$#:#.$$L.#.$#
#...@...$L:#.#....$$#
#.......$#:#......U$#
R$$#$$..x#:R$$..#..x#
####U###U#:####U#####
||||||||||:||||||||||
##########:##########
##.$$$..L#:#.$##$$$$#
#...$$..##:#..R..####
#.$..$$..#:#.......x#
#Rx....$.#:#$...#####
##########:#U########
||||||||||:||||||||||