##########
#.$$#$$$$#
#...@...$#
#.......$#
#$$#$$..x#
##########