12,1/12,8/2,8
##########:##########
R.$$#$$$$L:#.$$L.#.$#
#...@...$L:#.#....$$#
#.......$#:#......U$#
R$$#$$..x#:R$$..#..x#
####U###U#:####U#####
||||||||||:||||||||||
##D#######:##########
##.$$$..L#:#.$##$$$$#
R...$$..##:#..R..####
#.$..$$..L:#.......x#
#Rx....$.#:#$...#####
##########:#U########
||||||||||:||||||||||