##########
#..$#$$$$#
#...@...$#
#.......$#
#$$#....x#
##########