##########
#.$$#$$$$#
#...@...$#
#.......$#
#$$#$$..x#
##########
||||||||||
##########
#.$##$$$$#
#.....####
#.......x#
#....#####
##########
||||||||||