##########
#.$$#$$$$#
#...@...$#
#.......$#
#$$#$$..x#
##########
||||||||||
##########
#x$$#$$$$#
#...#.####
#.......x#
#..##.####
##########